11 11
1 1 1 1 1 1 1 1 1 1 1
1 2 0 0 0 0 0 0 0 0 1
1 0 1 1 1 1 0 1 1 0 1
1 0 1 1 1 1 0 1 1 0 1
1 0 1 1 1 2 0 1 1 0 1
1 0 1 1 1 0 1 1 1 0 1
1 0 1 1 1 0 1 1 1 0 1
1 0 1 1 0 0 1 1 1 0 1
1 0 1 1 0 0 1 1 1 0 1
1 0 0 0 0 0 0 0 0 2 1
1 1 1 1 1 1 1 1 1 1 1
7
1 9
9 1